nameOfIssuer	titleOfClass	cusip	value	shrsOrPrnAmt_	shrsOrPrnAmt_	investmentDiscretion	votingAuthority_Sole	votingAuthority_Shared	votingAuthority_None
2U INC	COM	90214J101	4106	57957	SH	DFND	57957	0	0
2U INC	COM	90214J101	13937	196708	SH	SOLE	180236	0	16472
2U INC	COM	90214J101	44242	624444	SH	DFND	624444	0	0
ADOBE INC	COM	00724F101	4242	15917	SH	DFND	15917	0	0
ADOBE INC	COM	00724F101	13238	49674	SH	SOLE	45581	0	4093
ADOBE INC	COM	00724F101	42015	157661	SH	DFND	157661	0	0
ALIBABA GROUP HLDG LTD	SPONSORED ADS	01609W102	3966	21736	SH	DFND	21736	0	0
ALIBABA GROUP HLDG LTD	SPONSORED ADS	01609W102	13426	73589	SH	SOLE	67430	0	6159
ALIBABA GROUP HLDG LTD	SPONSORED ADS	01609W102	42297	231827	SH	DFND	231827	0	0
ALLIANCE DATA SYSTEMS CORP	COM	018581108	3889	22223	SH	DFND	22223	0	0
ALLIANCE DATA SYSTEMS CORP	COM	018581108	13239	75662	SH	SOLE	69325	0	6337
ALLIANCE DATA SYSTEMS CORP	COM	018581108	41648	238017	SH	DFND	238017	0	0
ALPHABET INC	CAP STK CL C	02079K107	3893	3318	SH	DFND	3318	0	0
ALPHABET INC	CAP STK CL C	02079K107	13204	11254	SH	SOLE	10239	0	1015
ALPHABET INC	CAP STK CL C	02079K107	41557	35419	SH	DFND	35419	0	0
AMAZON COM INC	COM	023135106	3887	2183	SH	DFND	2183	0	0
AMAZON COM INC	COM	023135106	13069	7339	SH	SOLE	6727	0	612
AMAZON COM INC	COM	023135106	38580	21665	SH	DFND	21665	0	0
CARMAX INC	COM	143130102	4443	63659	SH	DFND	63659	0	0
CARMAX INC	COM	143130102	15079	216037	SH	SOLE	197912	0	18125
CARMAX INC	COM	143130102	47377	678758	SH	DFND	678758	0	0
COMSCORE INC	COM	20564W105	2393	118178	SH	DFND	118178	0	0
COMSCORE INC	COM	20564W105	7054	348329	SH	SOLE	319939	0	28390
COMSCORE INC	COM	20564W105	24915	1230354	SH	DFND	1230354	0	0
DICKS SPORTING GOODS INC	COM	253393102	4129	112165	SH	DFND	112165	0	0
DICKS SPORTING GOODS INC	COM	253393102	13927	378339	SH	SOLE	346674	0	31665
DICKS SPORTING GOODS INC	COM	253393102	44066	1197107	SH	DFND	1197107	0	0
EXPEDIA GROUP INC	COM NEW	30212P303	3812	32036	SH	DFND	32036	0	0
EXPEDIA GROUP INC	COM NEW	30212P303	12936	108708	SH	SOLE	99605	0	9103
EXPEDIA GROUP INC	COM NEW	30212P303	41405	347944	SH	DFND	347944	0	0
FACEBOOK INC	CL A	30303M102	3897	23377	SH	DFND	23377	0	0
FACEBOOK INC	CL A	30303M102	13273	79627	SH	SOLE	72973	0	6654
FACEBOOK INC	CL A	30303M102	38542	231219	SH	DFND	231219	0	0
GLOBALSTAR INC	COM	378973408	794	1846877	SH	DFND	1846877	0	0
GLOBALSTAR INC	COM	378973408	1792	4166418	SH	SOLE	3838145	0	328273
GLOBALSTAR INC	COM	378973408	7788	18112153	SH	DFND	18112153	0	0
IMAX CORP	COM	45245E109	1019	44927	SH	DFND	44927	0	0
IMAX CORP	COM	45245E109	503	22165	SH	SOLE	22165	0	0
IMAX CORP	COM	45245E109	6464	285021	SH	DFND	285021	0	0
JD COM INC	SPON ADR CL A	47215P106	3513	116532	SH	DFND	116532	0	0
JD COM INC	SPON ADR CL A	47215P106	1788	59320	SH	SOLE	59320	0	0
JD COM INC	SPON ADR CL A	47215P106	23065	765011	SH	DFND	765011	0	0
LIBERTY LATIN AMERICA LTD	COM CL C	G9001E128	2833	145630	SH	DFND	145630	0	0
LIBERTY LATIN AMERICA LTD	COM CL C	G9001E128	1392	71580	SH	SOLE	71580	0	0
LIBERTY LATIN AMERICA LTD	COM CL C	G9001E128	18241	937828	SH	DFND	937828	0	0
LULULEMON ATHLETICA INC	COM	550021109	3177	19390	SH	DFND	19390	0	0
LULULEMON ATHLETICA INC	COM	550021109	1629	9941	SH	SOLE	9941	0	0
LULULEMON ATHLETICA INC	COM	550021109	19872	121268	SH	DFND	121268	0	0
NETFLIX INC	COM	64110L106	3858	10819	SH	DFND	10819	0	0
NETFLIX INC	COM	64110L106	13237	37124	SH	SOLE	34005	0	3119
NETFLIX INC	COM	64110L106	42033	117885	SH	DFND	117885	0	0
NIKE INC	CL B	654106103	3219	38228	SH	DFND	38228	0	0
NIKE INC	CL B	654106103	1633	19390	SH	SOLE	19390	0	0
NIKE INC	CL B	654106103	21153	251188	SH	DFND	251188	0	0
PALO ALTO NETWORKS INC	COM	697435105	4109	16917	SH	DFND	16917	0	0
PALO ALTO NETWORKS INC	COM	697435105	13949	57431	SH	SOLE	52617	0	4814
PALO ALTO NETWORKS INC	COM	697435105	44251	182194	SH	DFND	182194	0	0
PAYPAL HLDGS INC	COM	70450Y103	3877	37338	SH	DFND	37338	0	0
PAYPAL HLDGS INC	COM	70450Y103	12992	125114	SH	SOLE	114690	0	10424
PAYPAL HLDGS INC	COM	70450Y103	38493	370694	SH	DFND	370694	0	0
PIVOTAL SOFTWARE INC	COM CL A	72582H107	3302	158367	SH	DFND	158367	0	0
PIVOTAL SOFTWARE INC	COM CL A	72582H107	1681	80605	SH	SOLE	80605	0	0
PIVOTAL SOFTWARE INC	COM CL A	72582H107	21674	1039539	SH	DFND	1039539	0	0
POLARITYTE INC	COM	731094108	739	69054	SH	DFND	69054	0	0
POLARITYTE INC	COM	731094108	348	32505	SH	SOLE	32505	0	0
POLARITYTE INC	COM	731094108	4648	434408	SH	DFND	434408	0	0
PROOFPOINT INC	COM	743424103	3286	27060	SH	DFND	27060	0	0
PROOFPOINT INC	COM	743424103	1691	13924	SH	SOLE	13924	0	0
PROOFPOINT INC	COM	743424103	21843	179881	SH	DFND	179881	0	0
PTC INC	COM	69370C100	3469	37631	SH	DFND	37631	0	0
PTC INC	COM	69370C100	1745	18927	SH	SOLE	18927	0	0
PTC INC	COM	69370C100	22557	244707	SH	DFND	244707	0	0
PVH CORP	COM	693656100	3173	26020	SH	DFND	26020	0	0
PVH CORP	COM	693656100	1626	13330	SH	SOLE	13330	0	0
PVH CORP	COM	693656100	19839	162685	SH	DFND	162685	0	0
RH	COM	74967X103	3648	35439	SH	DFND	35439	0	0
RH	COM	74967X103	10676	103703	SH	SOLE	95273	0	8430
RH	COM	74967X103	35972	349412	SH	DFND	349412	0	0
ROKU INC	COM CL A	77543R102	3884	60210	SH	DFND	60210	0	0
ROKU INC	COM CL A	77543R102	13189	204456	SH	SOLE	187328	0	17128
ROKU INC	COM CL A	77543R102	42221	654493	SH	DFND	654493	0	0
SALESFORCE COM INC	COM	79466L302	4033	25467	SH	DFND	25467	0	0
SALESFORCE COM INC	COM	79466L302	13691	86452	SH	SOLE	79214	0	7238
SALESFORCE COM INC	COM	79466L302	43660	275684	SH	DFND	275684	0	0
SEA LTD	SPONSORED ADS	81141R100	2238	95137	SH	DFND	95137	0	0
SEA LTD	SPONSORED ADS	81141R100	1212	51551	SH	SOLE	51551	0	0
SEA LTD	SPONSORED ADS	81141R100	15889	675547	SH	DFND	675547	0	0
SHUTTERFLY INC	COM	82568P304	1597	39300	SH	DFND	39300	0	0
SHUTTERFLY INC	COM	82568P304	840	20679	SH	SOLE	20679	0	0
SHUTTERFLY INC	COM	82568P304	10337	254345	SH	DFND	254345	0	0
SS&C TECHNOLOGIES HLDGS INC	COM	78467J100	2002	31426	SH	DFND	31426	0	0
SS&C TECHNOLOGIES HLDGS INC	COM	78467J100	974	15296	SH	SOLE	15296	0	0
SS&C TECHNOLOGIES HLDGS INC	COM	78467J100	12591	197691	SH	DFND	197691	0	0
STAMPS COM INC	COM NEW	852857200	2066	25376	SH	DFND	25376	0	0
STAMPS COM INC	COM NEW	852857200	6844	84063	SH	SOLE	77039	0	7024
STAMPS COM INC	COM NEW	852857200	21553	264744	SH	DFND	264744	0	0
TESLA INC	COM	88160R101	2536	9060	SH	DFND	9060	0	0
TESLA INC	COM	88160R101	8818	31510	SH	SOLE	28880	0	2630
TESLA INC	COM	88160R101	26368	94220	SH	DFND	94220	0	0
TYLER TECHNOLOGIES INC	COM	902252105	3989	19518	SH	DFND	19518	0	0
TYLER TECHNOLOGIES INC	COM	902252105	13241	64780	SH	SOLE	59372	0	5408
TYLER TECHNOLOGIES INC	COM	902252105	42289	206891	SH	DFND	206891	0	0
ULTA BEAUTY INC	COM	90384S303	1841	5280	SH	DFND	5280	0	0
ULTA BEAUTY INC	COM	90384S303	893	2560	SH	SOLE	2560	0	0
ULTA BEAUTY INC	COM	90384S303	11581	33210	SH	DFND	33210	0	0
VISA INC	COM CL A	92826C839	3412	21845	SH	DFND	21845	0	0
VISA INC	COM CL A	92826C839	1734	11099	SH	SOLE	11099	0	0
VISA INC	COM CL A	92826C839	22383	143309	SH	DFND	143309	0	0
WORLDPAY INC	CL A	981558109	3409	30031	SH	DFND	30031	0	0
WORLDPAY INC	CL A	981558109	1735	15290	SH	SOLE	15290	0	0
WORLDPAY INC	CL A	981558109	22375	197140	SH	DFND	197140	0	0
